                                                                                                                                                                                                                                                                                                                                
                                                                      ########                                                                                                                                                                                                                                                  
                                                                    #                                                                                                                                                            #######          #######                                                                       
                                              ########        ####                                                                          #######                                                                                                                                                                             
                                        ###              ##                                                                                                                                                                                                          ###################                                        
                                  ####                                          ####                                                   ####                                                                                ####       ##############                                                                            
                       ########                                         ######                 #############                   #####                                                                                                                                                                                          F 
          M                              ###############    ##########                                                                         ###########    ##   #####   #####   ##   ###  ###                                                       ##################               #############     ###   ##   ########## 
    #################                                                                ########                 ####     ######                                                                                          ##    ###############                                                                                    
                                                 ##########              ####  ####                                             ############                          ##                                                                                                    #########                                           
                                                                                                                                                                ###                                         ########                                                                                                            
                          #######  ##    ########                                               ##########                                          ##########                                     #######                                     ########   ##############                                                        